+---+---+---+---+---+---+---+---+---+---+---+
|       | R R R R R R R R R R R R R R R R R |
+---+   + R +---+---+   +---+---+---+---+   +
|       | R         |           |       |   |
+   +---+ R +---+---+---+---+---+---+   +   +
|   | R R R |                   |   |   |   |
+   + R +---+   +---+---+---+   +   +   +   +
|   | R R R R R R R R R |   |   |       | E |   
+   +---+---+---+---+   +   +   +   +   +   +
|                       |   |       |   |   |
+---+---+---+---+---+---+   +---+---+   +---+
| S S S S S S S S S | S S S |               |
+   +---+   +---+ S + S + S +---+---+---+   +
|   | K         | S S S | S S S S S         |
+---+---+---+---+---+---+---+---+---+---+---+
