+---+---+---+---+---+---+
|O E K                  |
+---+   +   +---+---+   +
|       |   |       |   |
+   +---+   +   +---+---+
|   |       |              
+   +   +---+   +---+---+
|   |                   |
+---+---+---+---+---+   +
|                      E|
+---+---+---+---+---+---+
