+---+---+---+---+---+---+
|                       |
+---+   +   +---+---+   +
|       |   |       |   |
+   +---+   +   +---+---+
|   |       |         E |
+   +   +---+   +---+---+
|   |                   |
+---+---+---+---+---+   +
| K                     |
+---+---+---+---+---+---+
